72 20
130 300
9 9 9 9 9 9 9 9 9 9 9 9 9 9 9 9 9 9 9 9 9 9 9 9 9 9 9 9 9 9 9 9 20 20 20 20 20 20 20 20 20 20 20 20 20 20 3 3 3 3 3 3 3 3 3 3 3 3 3 3 3 3 3 3 3 3 3 3 3 3 3 3
9 9 9 9 9 9 9 9 9 9 9 9 9 9 9 9 9 9 9 9 9 9 9 9 9 9 9 9 9 9 9 9 20 20 20 20 20 20 20 20 20 20 20 20 20 20 3 3 3 3 3 3 3 7 7 7 7 7 7 7 7 7 7 7 7 7 7 7 7 7 7 3
9 9 9 9 10 10 10 10 10 10 10 10 10 10 10 10 10 10 10 10 10 10 10 9 9 9 9 9 9 9 9 20 21 21 21 20 20 21 21 21 21 21 21 21 20 20 3 3 3 3 3 3 3 7 4 4 4 4 4 4 4 4 4 4 4 4 4 4 4 4 7 3
9 9 10 9 9 10 10 10 10 10 10 10 10 10 10 10 10 10 10 10 10 10 10 10 9 9 9 9 9 9 9 20 21 21 21 21 21 21 21 21 21 21 21 21 20 20 3 3 3 3 3 7 7 7 4 4 4 4 4 4 4 4 4 4 4 4 4 4 4 4 7 3
9 9 10 10 9 9 10 10 10 10 10 10 10 10 10 10 10 10 10 10 10 10 10 10 9 9 9 9 9 9 9 20 21 21 21 21 21 21 21 21 21 21 21 21 20 20 3 3 3 3 3 7 4 4 4 4 4 4 4 4 4 4 4 4 4 4 4 4 4 4 7 3
9 9 10 10 10 9 9 10 10 10 10 10 10 10 10 10 10 10 10 10 10 10 10 9 9 9 9 9 9 9 9 20 21 21 21 21 21 21 21 21 21 21 21 21 20 20 3 3 3 3 3 7 4 4 4 4 4 4 4 4 4 4 4 4 4 4 4 4 4 4 7 3
9 9 10 10 10 10 9 9 10 10 10 10 10 10 10 10 10 10 10 10 10 10 9 9 9 9 9 9 9 9 9 20 21 21 21 21 21 21 21 21 21 21 21 21 20 20 3 7 7 7 7 7 4 4 4 4 4 3 3 3 3 3 3 4 4 4 4 4 4 4 7 3
9 9 9 10 10 10 10 9 9 10 10 10 10 10 10 10 10 10 10 10 9 9 9 9 9 9 9 9 9 9 9 20 21 21 21 21 21 21 21 21 21 21 21 21 20 20 3 7 4 4 4 4 4 4 4 4 4 4 4 4 4 4 4 4 4 4 4 4 4 4 7 3
9 9 9 10 10 10 10 10 10 10 10 10 10 10 10 10 10 10 10 10 10 9 9 9 9 9 9 9 9 9 9 20 21 21 21 21 21 21 21 21 21 21 21 21 20 20 3 7 4 4 4 4 4 4 4 4 3 4 4 4 4 4 4 4 4 4 4 4 4 4 7 3
9 9 9 10 10 10 10 10 10 10 10 10 10 10 10 10 10 10 10 10 10 10 10 10 10 10 10 21 21 21 21 21 21 21 20 20 20 21 21 21 21 21 21 21 21 7 7 7 4 4 4 4 4 4 4 4 4 4 4 4 4 4 4 4 4 4 4 4 4 4 7 3
9 9 9 10 10 10 10 10 10 10 10 10 10 10 10 10 10 10 10 10 10 10 10 10 10 10 10 21 21 21 21 21 21 21 20 20 20 21 21 21 21 21 21 21 21 7 7 7 4 4 4 4 4 4 4 4 4 4 4 4 4 4 4 4 4 4 4 4 4 4 7 3
9 9 9 10 10 10 10 10 10 10 10 10 10 10 10 10 10 10 10 10 10 9 9 9 9 9 9 9 9 9 9 20 21 21 21 21 21 21 21 21 21 21 21 21 20 20 3 7 4 4 4 4 4 4 4 4 3 4 4 4 4 4 4 4 4 4 4 4 4 4 7 3
9 9 10 10 10 10 10 9 9 10 10 10 10 10 10 10 10 10 10 10 9  9 9 9 9 9 9 9 9 9 9 20 21 21 21 21 21 21 21 21 21 21 21 21 20 20 3 7 4 4 4 4 4 4 4 4 4 4 4 4 4 4 4 4 4 4 4 4 4 4 7 3
9 9 10 10 10 10 9 9 10 10 10 10 10 10 10 10 10 10 10 10 10 10 9 9 9 9 9 9 9 9 9 20 21 21 21 21 21 21 21 21 21 21 21 21 20 20 3 7 7 7 7 7 4 4 4 4 4 3 3 3 3 3 3 4 4 4 4 4 4 4 7 3
9 9 10 10 10 9 9 10 10 10 10 10 10 10 10 10 10 10 10 10 10 10 10 9 9 9 9 9 9 9 9 20 21 21 21 21 21 21 21 21 21 21 21 21 20 20 3 3 3 3 3 7 4 4 4 4 4 4 4 4 4 4 4 4 4 4 4 4 4 4 7 3
9 9 10 10 9 9 10 10 10 10 10 10 10 10 10 10 10 10 10 10 10 10 10 10 9 9 9 9 9 9 9 20 21 21 21 21 21 21 21 21 21 21 21 21 20 20 3 3 3 3 3 7 4 4 4 4 4 4 4 4 4 4 4 4 4 4 4 4 4 4 7 3
9 9 10 9 9 10 10 10 10 10 10 10 10 10 10 10 10 10 10 10 10 10 10 10 9 9 9 9 9 9 9 20 21 21 21 21 21 21 21 21 21 21 21 21 20 20 3 3 3 3 3 7 7 7 4 4 4 4 4 4 4 4 4 4 4 4 4 4 4 4 7 3
9 9 9 9 10 10 10 10 10 10 10 10 10 10 10 10 10 10 10 10 10 10 10 9 9 9 9 9 9 9 9 20 21 21 21 20 20 21 21 21 21 21 21 21 20 20 3 3 3 3 3 3 3 7 4 4 4 4 4 4 4 4 4 4 4 4 4 4 4 4 7 3
9 9 9 9 9 9 9 9 9 9 9 9 9 9 9 9 9 9 9 9 9 9 9 9 9 9 9 9 9 9 9 9 20 20 20 20 20 20 20 20 20 20 20 20 20 20 3 3 3 3 3 3 3 7 7 7 7 7 7 7 7 7 7 7 7 7 7 7 7 7 7 3
9 9 9 9 9 9 9 9 9 9 9 9 9 9 9 9 9 9 9 9 9 9 9 9 9 9 9 9 9 9 9 9 20 20 20 20 20 20 20 20 20 20 20 20 20 20 3 3 3 3 3 3 3 3 3 3 3 3 3 3 3 3 3 3 3 3 3 3 3 3 3 3